ANA: Arch Nova Alpha
ANE: Arch Nova Elite
AV: Ayrkrane Vik
Ayr: Ayrkrane
BC: Blight Crusher
BCg: Bolt Crag
BzP: Blitz Plate
CA: Crushing Anvil
CJ: Covert Jet
Const: Constantine
CP: Contaminant Purifier
CS: Corrosive Spore
DFan: Deranged Fanatic
DF: Death Factory
DQ: Draconian Queen
DV: Dutiful Veteran
Eerie: Narscious the Eerie
Emp: Empress
GF: Garrison Fortifier
HA: Havoc Alpha
HD: Heart Devourer
HG: Havoc Genesis
IA: Inspiring Altar
IT: Indestructible Troop
IV: Indebted Veteran
MJ: Mach Jet
MwA: Masterwork Aegis
NbD: Noble Defiance
Nex: Nexor
Bar: Barracus
PD: Pantheon Disciple
Pet: Petrisis
RF: Reckless Fanatic
RM: Razor Maiden
SF: Starformer
SN: Stealthy Niaq
SR: Spiteful Raptor
SacS: Sacred Sanctuary
SS: Shining Sanctuary
TB: Tartarus Brood
TS: Tartarus Scion
TtD: Tiamat the Destroyer
Vex: Typhon Vex
VK: Valiant Knight
VR: Venomous Raptor
XO: Xeno Overlord
XS: Xeno Suzerain
ZH: Zodiac Harbinger
